####################
#############*######
############# ######
####          ######
####### ############
####### ############
####### ############
#######       *#####
####### ##### ######
####### ##### ######
####### ##### ######
####### ##### ######
#######       ######
############# ######
#######*##### ######
####### ##### ######
#####*        ######
########## #########
########## #########
####################
