#########################################################################
#########################################################################
#########################################################################
#########################################################################
                                      ###################################
##################################### ###################################
##################################### ################     *#############
##################################### ################ ##################
##################################### ################ ##################
##################################### ################ ##################
##################################### ################ ##################
#####################################                          *#########
##################################### ###################################
###########              ############ ###################################
##########               ############ ###################################
#########*                            ###########################
##########               ############ ########################### #######
###########              ############ ########################### #######
##################################### ########################### #######
#################################                                 #######
################################################ ########################
################################################ ########################
################################################ ########################
###############################* ############### ########################
################################ ############### ########################
################################ ############### ########################
################################                                #########
################################ ############################## #########
####!      ##################### ############################## #########
########## #############            ########################### #########
#########                ########## ########################### #########
###################################*########################### #########
############################################################### #########
